NO ./assets/textures/philwall.xpm
SO ./assets/textures/philwall.xpm
WE ./assets/textures/philwall.xpm
EA ./assets/textures/philwall.xpm

F 246,220,189
C 135,   206 ,  235

111111
111111
11N011
111111
111111