NO ./assets/textures/wall_3.xpm
SO ./assets/textures/wall_3.xpm
WE ./assets/textures/wall_3.xpm
EA ./assets/textures/wall_3.xpm

F 100,100,100
C 50,50,50

111111
100101
100001
1000N1
100001
100001
100001
100011
100001
100001
100001
111111