NO ./assets/textures/wall_n.xpm
SO ./assets/textures/wall_s.xpm
WE       ./assets/textures/wall_w.xpm

F   220, 100,3        
                C    225,30,  55

EA    ./assets/textures/wall_e.xpm

    1111111111111111111111111
    1000000000110000000000001
    1011000001110000000000001
    1001000000000000000000001
1111111110110000011100000000011111111
100000000011000001110111111111111
11110111111111011100000010001
11111111111111111111111111001
101                       101
101              1        101              1
101             1N1       111             101
101              1        101              1
101                       101
101                       101 
101                       101
101                       101
101                       101
11111111111111111111111111101
10000000000000001100000010001
100000000000000011010111000101
110000011101010111101111010111
11110111 1110101 101111010001
11111111 1111111 111111111111





