NO ./assets/textures/wall_3.xpm
SO ./assets/textures/wall_3.xpm
WE ./assets/textures/wall_3.xpm
EA ./assets/textures/wall_3.xpm

F 246,220,189
C 135,   206 ,  235

    1111111111111111111111111
    1000000000110000000000001
    1011000001110000000000001
    1001000000000000000000001
1111111110110000011100000000011111111
100000000011000001110111111111111
11110111111111011100000010001
11110111111111011101010010001
11000000110101011100000010001
10000N00000000001100000010001
10000000000000001101010010001
1100000111010101111101000111
11110111 1110101 10111100001
11111111 1111111 111111111111