NO ./assets/textures/wall_n.xpm
SO ./assets/textures/wall_s.xpm
WE ./assets/textures/wall_w.xpm
EA ./assets/textures/wall_e.xpm

F 220,100,255    
C 225,30,55

    1111111111111111111111111
    1000000000110000000000001
    1011000001110000000000001
    1001000000000000000000001
1111111110110000011100000000011111111
100000000011000001110111111111111
11110111111111111100000010001
1111011111111111101010010001
11000000110101111100000010001
10000000000000001100000010001
10000000000000001101010010001
11000001110101011110111100111
11110111 1110101 11111W100011
11111111 1111111 111111111111