NO ./assets/textures/11zon_north.xpm
SO ./assets/textures/11zon_south.xpm
WE ./assets/textures/11zon_west.xpm
EA ./assets/textures/11zon_east.xpm

F 100,100,100
C 50,50,50

    1111111111111111111111111
    1000000000110000000000001
    1011000001110000000000001
    1001000000000000000000001
1111111110110000011100000000011111111
100000000011000001110111111111111
11110111111111011100000010001
11110111111111011101010010001
111000000110101011100000010001
10000000N000000001100000010001
111000000000000001101010010001
11000001110101011110111100111
11110111 1110101 101111010001
11111111 1111111 111111111111