NO ./assets/textures/wall_3.xpm
SO ./assets/textures/wall_3.xpm
WE ./assets/textures/wall_3.xpm
EA ./assets/textures/wall_3.xpm

F 1,100,0
C 44,30,44

    1111111111111111111111111
    1000000000110000000000001
    1011000001110000000000001
    1001000000000000000000001
1111111110110000011100000000011111111
100000000011000001110111111111111
11110111111111011100000010001
11110111111111011101010010001
11000000110101011100000010001
10000000000000001100000010001
100000000000000S1101010010001
11000001110101011110111100111
11110111 1110101 101111010001
11111111 1111111 111111111111