NO ./assets/textures/philwall.xpm
SO ./assets/textures/philwall.xpm
WE ./assets/textures/philwall.xpm
EA ./assets/textures/philwall.xpm

F 246,220,189
C 135,206,235

11111111
11100111
11110111
11110111
11100111
11100111
11110N01
11111111
